+---+---+---+---+
        |       |
+---+   +---+---+
|       |       |
+   +---+---+   +
|               |
+---+---+---+   +
|       |   |    
+---+---+---+---+
6 6 4 4 6 6 6 6 6 6 6 6 14 14 15 6 
